

C 8, 143, 143
R  2147483647 2147483647
NO ./images/NO.xpm
SO ./images/SO.xpm
WE ./images/WE.xpm
EA ./images/EA.xpm
S ./textures/ITEM.xpm
F  255, 15, 0




111111111111111111111111111111
111111111S00200000000000011111
100000000000000000111000100001
110000100000000000000000001111
100001111111000000020000111111
011111100000000000000000000001
111100000000001100000002000011
1                            1
110000000000011110000000000011
100000000000111000000000000011
110000000000111000000000001111
110000000001111000000000000111
111111111111111111111111111111111
