NO ./images/NO.xpm
SO ./images/SO.xpm
WE ./images/WE.xpm
EA ./images/EA.xpm


F 26,75,247
C 255,215,0



    11111111111111111111111111
    1000000000110000000000001
    1011000001110000000000001
    1001000000000000000000001
    1111101101100001110000000000001
    100000000011000001110111111111111
11110111111111011100000010001
11110111111111011101010010001
11000000110101011100000010001
1000000000000001100000010001
100000S0000000001101010010001
1100000111010101111101111000111
11110111 1110101 101111010001
11111111 1111111 1111111111111